{{0,0,1,0,0,0,0,5,4,1,1,1,1,1},
{0,0,1,1,1,1,0,0,0,0,0,0,0,0},
{0,0,0,0,0,0,1,0,0,0,0,0,0,0},
{0,0,1,1,0,0,4,1,0,0,0,0,0,0},
{0,0,0,4,0,0,0,0,4,4,0,2,2,1},
{1,0,0,1,0,0,0,0,0,0,0,4,4,0},
{0,0,0,0,1,3,1,2,1,0,1,9,1,0},
{1,1,3,5,0,3,1,0,0,0,0,1,0,3}}