{{0,0,0,0,0,0,0,0,0,0,0,0,0},
 {0,0,0,0,0,0,0,0,0,3,0,0,9},
 {0,0,5,0,4,0,2,0,3,0,4,4,0},
 {0,0,2,5,4,4,3,2,2,0,5,3,0},
 {0,0,3,2,3,5,9,4,3,0,5,2,0},
 {0,0,0,2,2,3,3,2,5,3,0,0,0},
 {0,2,0,0,0,0,0,0,0,0,0,0,0},
 {0,0,0,0,0,0,0,0,2,0,0,0,0},
 {0,0,2,2,2,0,2,2,4,0,0,0,0},
 {0,2,0,0,0,0,0,0,0,0,0,2,0}};